brief - of short duration not lasting for long
foray - an sudden attach or incursion into enemy territory
cluster - a group of similar things or people positioned or occuring closely together
aggregate - form or group into a class or cluster
restraint - a measure or condition that keeps someone or something under control
inhibited - unable to act in a relaxed and natural way because of self-consciousness or mental restraint
overawe - impress someone so much that they are silent or inhibited
intimidate - frighten or overawe someone especially in order to make them do what one wants
jargon - special words or expression that are used by a group of people and are difficult to understand by others
curated - selected, organized and presented using professional or expert knowledge
vital - absolutely necessary
consultant - a person who provides expert advice professionally
consultancy - a professional practice that gives expert advice with in a particular field
acknowledge - accept or admit the existence or truth of
subconsciously - not fully aware
scrutinize - examine or inspect closely and thoroughly
supplementory - completing or enhancing something
compel - force or obligue someone to do something
consiquently - as a result
intuation - the ability to understand something instinctively, without the need of conscious reasoning
counterintuitive - countrary to intuition or to common sense expectation
fatigue - cause someone to feel exhausted
exertion - physical or mental effort
strenuous - requiring or using great effort or exertion
arduous - involving or requiring strenuous effort
veteran - a person who has a long experience in a particular field
yeild - produce or provide
co-dependent - characterized by excessive emotional or psychological relience on a partner
definite - not doubtful
decisive - setting an issue; producing a definite result
crucial - decisive or critical, specially in a success or failure of something
rigorous - extreamly thorough and careful
constituent - being a part of whole
interconnected - having all the constituent parts linked or connected together
holistic - characterized by the belief that the parts of something are interconnected and can be explained only by reference to the whole
indispensable - absolutely necessary
reconcilition - the restoration of firendly relations
aid - help and support
assistive - designed to aid a person with a disability
semeantic - relating to meaning in language or logic
semantically - means in a way that is connected to the meaning of words
terminology - the body of terms used in a particular technical area, subject of study, profession
uncertain - not able to be relied on
vague - uncertain, unclear meaning
